None	None	None
Ad	Aldumite	Unique
Ag	Silver	Uncommon
Al	Aluminum	Common
Ar	Argon	Common
Au	Gold	Rare
Be	Beryllium	Uncommon
C6Hn	Benzene	Uncommon
Cl	Chlorine	Common
Co	Cobalt	Uncommon
Cs	Caesium	Exotic
Cu	Copper	Common
Dy	Dysprosium	Exotic
Eu	Europium	Exotic
F	Fluorine	Uncommon
Fe	Iron	Common
H2O	Water	Common
He-3	Helium	Common
Hg	Mercury	Rare
HnCn	Alkanes	Uncommon
Ie	Indicite	Unique
IL	Ionic Liquids	Exotic
Ir	Iridium	Uncommon
Li	Lithium	Rare
Nd	Neodymium	Rare
Ne	Neon	Exotic
Ni	Nickel	Common
Pb	Lead	Common
Pd	Palladium	Exotic
Pt	Platinum	Rare
Pu	Plutonium	Exotic
R-COC	Carboxylic Acids	Uncommon
Rc	Rothicite	Unique
Sb	Antimony	Exotic
SiH3Cl	Chlorosilanes	Uncommon
Ta	Tantalum	Rare
Ti	Titanium	Rare
Tsn	Tasine	Unique
U	Uranium	Common
V	Vanadium	Rare
Vr	Veryl	Unique
Vy	Vytinium	Unique
W	Tungsten	Uncommon
Xe	Xenon	Exotic
xF4	Tetrafluorides	Rare
Yb	Ytterbium	Exotic
CT	Caelumite	Exotic